# This file contains place names in English and Welsh.
# It is used a by a rule that detects Anglsised place names and
# propose the Welsh names.
#
# It uses places names from BydTermCymru (downloadable version 02/03/2016)
# Crown copyright and database right 2016 - data released as CC-BY
#
# Author: Curon Wyn Davies <curon@wyn.cymru>
#
2nd Floor=2il Lawr
Abbey Cwmhir=Abaty Cwm-hir
Aberarth=Aber-arth
Aberavon Beach Hotel=Gwesty Traeth Aberafan
Aberdare=Aberdâr
Aberdovey=Aberdyfi
Abergavenny=Y Fenni
Aberglasney Gardens=Gerddi Aberglasne
Aberhafesp=Aberhafesb
Aberkenfig=Abercynffig
Aberporth=Aber-porth
Aberthaw=Aberddawan
Aeron Valley=Dyffryn Aeron
Afghanistan=Affganistan
Alexandra Park=Gerddi Alexandra
Alexandra Road=Ffordd Alexandra
Amelia Trust Farm=Fferm Ymddiriedolaeth Amelia
Amman Valley=Cwm Aman
Amman Valley=Dyffryn Aman
Ammanford=Rhydaman
Argentina=Ariannin
Astbury Quarry=Chwarel Astbury
Athens=Athen
Atlantic Ocean=Cefnfor Iwerydd
Atlantic Wharf=Glanfa'r Iwerydd
Australia=Awstralia
Austria=Awstria
Ayers Rock=Craig Ayers/Uluru
Backe=Bace
Baker Street=Stryd y Popty
Bala Lake=Llyn Tegid
#Bala=Y Bala
Bangor Is-y-Coed=Bangor Is-coed
Bansingwerk=Dinas Basing
Bardsey Island=Ynys Enlli
Barmouth=Abermo
Barry=Y Barri
Basement Park=Parc Tanddaearol
Basle=Basel
Bath=Caerfaddon
Bavaria=Bafaria
Beacons Way=Ffordd y Bannau
Beaumaris=Biwmares
Bedfordshire=Swydd Bedford
Bedwas Road=Heol Bedwas
Beguildy=Bugeildy
Belarus=Belarws
Belgium=Gwlad Belg
Belgrade=Belgrad
Benar Terrace=Rhes Benar
Bettws=Betws
Bishops Castle=Bishop's Castle
Bishopston=Llandeilo Ferwallt
Blackmoor Hill=Bryn Blackmoor
Blackwood=Coed-duon
Blaengwrach=Blaen-gwrach
Blaina=Blaenau
Bombay=Mumbai (Bombay)
#Borth=Y Borth
Brangwyn Hall=Neuadd Brangwyn
Brecon=Aberhonddu
Bridge Street=Stryd y Bont
Bristol Channel=Môr Hafren
Bristol Deep=Dyfnfor Bryste
Bristol=Bryste
British Memorial Garden=Yr Ardd Goffa Brydeinig
Briton Ferry=Llansawel
Brittany=Llydaw
Broad Haven=Aberllydan
Bromfield House=Tŷ Bromfield
Bron-y-nant Cemetery=Mynwent Bron-y-nant
Broncoed House=Tŷ Broncoed
Broughton=Brychdyn
Brunel House=Tŷ Brunel
Brynamman=Brynaman
Brynmawr=Bryn-mawr
Buckinghamshire=Swydd Buckingham
Buckley=Bwcle
Builth Wells=Llanfair-ym-Muallt
Bulgaria=Bwlgaria
Burgundy=Bwrgwyn
Burry Inlet=Cilfach Tywyn
Burry Port=Porth Tywyn
Bute Park=Parc Bute
Bute Street=Stryd Bute
Bute Town=Y Drenewydd
Buttington=Tal-y-bont
Cable Bay=Porth Trecastell
Cadwgan Place=Maes Cadwgan
Caerbwdy=Caerbwdi
Caerleon=Caerllion
Caerphilly Castle=Castell Caerffili
Caersws=Caersŵs
Caerwent=Caer-went
Caldicot=Cil-y-coed
Caldy Island=Ynys Bŷr
Cambrian Mountains=Mynyddoedd Cambria
Cambridgeshire=Swydd Gaergrawnt
Cameroon=Camerŵn
Canaston Bridge=Pont Canaston
Cancun=Cancún
Canterbury=Caergaint
Canton=Treganna
Capital Quarter=Cwr y Ddinas
Capital Square=Sgwâr y Ddinas
Capital Waterside=Glannau'r Brifddinas
Caradog House=Tŷ Caradog
Cardiff Bay Barrage=Morglawdd Bae Caerdydd
Cardiff Bay=Bae Caerdydd
Cardiff Capital Region=Prifddinas-Ranbarth Caerdydd
Cardiff Castle=Castell Caerdydd
Cardiff Gate=Porth Caerdydd
Cardiff International Arena=Arena Ryngwladol Caerdydd
Cardiff Office=Swyddfa Caerdydd
Cardiff=Caerdydd
Cardigan Bay=Bae Ceredigion
Cardigan=Aberteifi
Carew=Caeriw
Carmarthen=Caerfyrddin
Castle Buildings=Adeiladau'r Castell
Castle Caereinion=Castell Caereinion
Castle Ditch=Pen Deitsh
Castle Morris=Casmorys
Castle Point=Trwyn y Castell
Castle Terrace=Rhes y Castell
Castle=Y Castell
Castlemartin=Castell Martin
Cathays Park=Parc Cathays
Cathedine=Cathedin
Cedar Court=Cedar Court
Central Asia=Asia Ganol
Central Cardiff Transport Hub=Cyfnewidfa Drafnidiaeth Caerdydd Canolog
Central Valley Wetlands Park=Parc Gwlyptir Canol y Cwm
Charnwood Court=Cwrt Charnwood
Chepstow=Cas-gwent
Cheshire=Swydd Gaer
Chester=Caer
China=Tsieina
Chirk=Y Waun
Church Bay=Porth Swtan
Church Street=Stryd yr Eglwys
Church Village=Pentre'r Eglwys
Churchill Way=Ffordd Churchill
Churchstoke=Yr Ystog
Cinema=Sinema
City Hall=Neuadd y Ddinas
Clwydian Range=Bryniau Clwyd
Clydach Gorge=Cwm Clydach
Clydach Vale=Cwm Clydach
Clydach gorge=ceunant Clydach
Coach-house=Coetsiws
Coed Eva=Coed Efa
Coedkernew=Coedcernyw
Coedpoeth=Coed-poeth
Cologne=Cwlen
Colwyn Bay=Bae Colwyn
Conference Room=Ystafell Gynadledda
Connah’s Quay=Cei Connah
Connemara=Conamara
Conway Falls=Rhaeadr y Graig Lwyd
Conwy Suspension Bridge=Pont Grog Conwy
Conwy Valley=Dyffryn Conwy
Cork=Corc
Cornwall=Cernyw
Cowbridge=Y Bont-faen
Coychurch=Llangrallo
Cracow=Krakow (Cracow)
Cray=Crai
Crete=Creta
Crick=Crug
Crickhowell=Crucywel
Criggion=Crugion
Crossgates=Y Groes
Crown Building=Adeilad y Goron
Crown Buildings=Adeiladau'r Goron
Crucorney=Crucornau
Crynant=Creunant
Culverhouse Cross=Croes Cwrlwys
Cwm Cynon Business Park=Parc Busnes Cwm Cynon
Cwmbran=Cwmbrân
Côte d’Ivoire=Y Traeth Ifori
Dee estuary=aber Afon Dyfrdwy
Democratic Republic of the Congo=Gweriniaeth Ddemocrataidd Congo
Denmark=Denmarc
Derbyshire=Swydd Derby
Devil’s Bridge=Pontarfynach
Devon=Dyfnaint
Dinas Head=Pen Dinas
Dinas Island=Ynys Dinas
Dinerth Road Offices=Swyddfeydd Ffordd Dinerth
Dinerth Road=Ffordd Dinerth
Dining Room=Ystafell Fwyta
Dinorwic=Dinorwig
Disserth=Diserth
Dixton=Llandidwg
Dublin=Dulyn
Duffryn=Dyffryn
Dunraven=Dwn-rhefn
Dyfi Bridge=Pont ar Ddyfi
Dylan Thomas’ Boathouse=y ‘Boathouse’, cartref Dylan Thomas
Eagles Meadow=Dôl yr Eryrod
East Core=Craidd y Dwyrain
East Midlands=Dwyrain Canolbarth Lloegr
East Service Core=Craidd Gwasanaethau'r Dwyrain
East Sussex=Dwyrain Sussex
East Timor=Dwyrain Timor
East Wales=Dwyrain Cymru
East Wing=Adain y Dwyrain
East of England=Dwyrain Lloegr
East=Dwyrain
Eastern Cleddau=Cleddau Ddu
Ebbw Vale Enterprise Zone=Ardal Fenter Glyn Ebwy
Ebbw Vale Parkway=Parcffordd Glynebwy
Ebbw Vale=Glynebwy
Ebbw Valley=Cwm Ebwy
Edinburgh=Caeredin
Eglwysbach=Eglwys-bach
Eglwyscummin=Eglwys Gymyn
Egypt=Yr Aifft
Eithinog Road=Ffordd Eithinog
Ely=Trelái
England=Lloegr
Erbistock=Erbistog
Erwood=Erwyd
Ewenny=Ewenni
Executive Suite=Swyddfeydd y Prif Swyddogion
Exeter=Caerwysg
FYROM=Cyn-weriniaeth Iwgoslafaidd Macedonia
Fairwater=Y Tyllgoed
Falkland Islands=Ynysoedd Falkland/ Ynysoedd Malvinas
Ferndale=Glynrhedynog
Festival Park Shopping Village=Pentref Siopa Parc yr Ŵyl
Finland=Y Ffindir
First Floor=Llawr Cyntaf
Fishguard=Abergwaun
Fitzalan Road=Ffordd Fitzalan
Flanders=Fflandrys
Flatholm=Ynys Echni
Flimstone Lane=Lôn Flimstone
Flint=Y Fflint
Florence=Fflorens
Forden=Ffordun
Forest of Dean=Fforest y Ddena
Forge Road=Ffordd y Bontfaen
Four Crosses=Llandysilio
Fourth Floor=Pedwerydd Llawr
France=Ffrainc
French=Ffrangeg
Galilee=Galilea
Gallows Point=Penrhyn Safnas
#Galon Uchaf=Y Galon Uchaf
Garden Court Coffee Bar=Bar Coffi Gerddi'r Cwrt
Gaza Strip=Llain Gaza
Gellideg=Gelli-deg
Geneva=Genefa
Genoa=Genova (Genoa)
Germany=Yr Almaen
Gerona=Girona
Giant's Causeway=Sarn y Cedwri
Giant’s Grave=Bedd-y-cawr
Ginst Point=Trwyn Ginst
Glasbury=Y Clas-ar-Wy
Gloucester=Caerloyw
Gloucestershire=Swydd Gaerloyw
Glyn Tarrell=Glyntarell
Glyn-neath=Glyn-nedd
Glyndŵr's Way=Llwybr Glyndŵr
Goodwick=Wdig
Gospel Pass=Bwlch yr Efengyl
Gothenburg=Göteborg
Government Buildings=Adeiladau'r Llywodraeth
Gower Peninsula=Penrhyn Gŵyr
Gower=Gŵyr
Gowerton=Tre-gŵyr
Graig Penllyn=Craig Pen-llin
Grangetown Peninsula=Pentir Grangetown
Great Orme=Pen y Gogarth
Greater Cardiff=Caerdydd Fwyaf
Greater Gwent=Gwent Fwyaf
Greater London=Llundain Fwyaf
Greater Manchester=Manceinion Fwyaf
Greater South East of England=De-ddwyrain Lloegr Fwyaf
Greaves Wharf=Cei Greaves
Greece=Gwlad Groeg
Green Bridge=Y Bont Werdd
Greenland=Kalaallit Nunaat (Greenland)
Greyfriars Shopping Centre=Canolfan Siopa'r Brodyr Llwyd
#Groes=Y Groes
Grosmont=Grysmwnt
Ground Floor=Llawr Daear
Ground=Llawr Daear
Grove Road=Grove Road
Guyana=Gaiana
Gwaun Valley=Cwm Gwaun
Gwnnwss Issa=Gwnnws Isa
Gwydyr House=Tŷ Gwydyr
Haiti=Haïti
Hamburg=Hambwrg
Hanover=Hanofer
Hanter Hill=Bryn Hanter
Havana=Hafana
Haven Waterway=Dyfrffordd y Ddau Gleddau
Haven's Head Business Park=Parc Busnes Haven's Head
Haverfordwest=Hwlffordd
Hawarden=Penarlâg
Hay on Wye=Y Gelli Gandryll
Hayscastle=Cas-lai
Heads of the Valleys=Blaenau'r Cymoedd
Heart of the Valleys=Y Cymoedd Canol
Heath Park=Parc y Mynydd Bychan
Heath=Y Mynydd Bychan
Helwick Bank=Cefnen Helwick
Hereford and Worcester=Henffordd a Chaerwrangon
Hereford=Henffordd
Herefordshire=Swydd Henffordd
Hergest Ridge=Cefn Hergest
Hertfordshire=Swydd Hertford
High Street=Pentre Bont
High Street=Y Stryd Fawr
Holland=Yr Iseldiroedd
Holy Island=Ynys Gybi
Holyhead Road=Ffordd Caergybi
Holyhead=Caergybi
Holywell=Treffynnon
Horseshoe Falls=Rhaeadr y Bedol
Horseshoe Pass=Bwlch yr Oernant
Humberside=Glannau Humber
Hungary=Hwngari
Iceland=Gwlad yr Iâ
Ilex Close=Clos Ilex
Ilston=Llanilltud Gŵyr
International Sports Village=Pentref Chwaraeon Rhyngwladol
Iraq=Irac
Ireland Moor=Rhos Ireland
Ireland=Iwerddon
Irish Republic=Gweriniaeth Iwerddon
Isle of Man=Ynys Manaw
Isle of Wight=Ynys Wyth
Istanbul=Istanbwl
Italy=Yr Eidal
Jerusalem=Jerwsalem
Johnstown=Tre Ioan
Jordan=Gwlad yr Iorddonen
Judaea=Jwdea
Kemeys Commander=Cemais Comawndwr
Kent=Caint
Kerry=Ceri
Kidwelly=Cydweli
King Street=Heol y Brenin
King Street=Stryt y Brenin
King's Lane=Lôn y Brenin
Kingsway=Ffordd y Brenin
Kington=Ceintun
Kinmel Bay=Bae Cinmel
Knelston=Llan-y-tair-mair
Knighton=Trefyclo
Lady Park Wood=Coed Lady Park
Ladywell House=Tŷ Ladywell
Lake Vyrnwy=Llyn Efyrnwy
Lampeter=Llanbedr Pont Steffan
Lamphey=Llandyfái
Lancashire=Swydd Gaerhirfryn
Landore=Glandŵr
Landsker Borderlands Trail=Llwybr Beicio'r Landsger
Lapland=Y Lapdir
Latvia=Latfia
Laugharne=Talacharn
Lavernock Point=Trwyn Larnog
Lavernock=Larnog
Lebanon=Libanus
Leckwith=Lecwydd
Leeswood=Coed-llai
Leicestershire=Swydd Gaerlŷr
Leominster=Llanllieni
Letterston=Treletert
Lincolnshire=Swydd Lincoln
Linden Court=Cwrt Linden
Lisbon=Lisboa (Lisbon)
Lisvane=Llys-faen
Litchard=Y Llidiart
Lithuania=Lithiwania
Little Haven=Aber Bach
Little Orme=Trwyn y Fuwch
Liverpool=Lerpwl
Llanafanfawr=Llanafan Fawr
Llanarth=Llan-arth
Llanarth=Llannarth
Llanbadoc=Llanbadog
Llandaff North=Ystum Taf
Llandaff=Llandaf
Llanddewi Brefi=Llanddewibrefi
Llanddewi Ystradenny=Llanddewi Ystradenni
Llandough=Llandochau
Llandovery=Llanymddyfri
Llandrindod Wells=Llandrindod
Llandudno Junction Design=Cynllun Cyffordd Llandudno
Llandudno Junction=Cyffordd Llandudno
Llanellen=Llanelen
Llanelli Millennium Coastal Park=Parc Arfordirol y Mileniwm Llanelli
Llanfair Kilgeddin=Llanfair Cilgedin
Llanfair Talhaiarn=Llanfair Talhaearn
Llanfoist Fawr=Llan-ffwyst Fawr
Llangan=Llan-gan
Llangattock-Vibon-Avel=Llangatwg Feibion Afel
Llangattock=Llangatwg
Llangeinor=Llangeinwyr
Llangelynin=Llangelynnin
Llangorse Lake=Llyn Syfaddan
Llangorse=Llan-gors
Llangunllo=Llangynllo
Llangunnor=Llangynnwr
Llangyniew=Llangynyw
Llanhennock=Llanhenwg
Llanhilleth=Llanhiledd
Llanishen=Llanisien
Llanllowell=Llanllywel
Llanllwchaiarn=Llanllwchaearn
Llanmadoc=Llanmadog
Llannefydd=Llanefydd
Llannon=Llan-non
Llanover=Llanofer
Llanrumney=Llanrhymni
Llantilio Crosenny=Llandeilo Gresynni
Llantrisant Fawr=Llantrisaint Fawr
Llantwit Fardre=Llanilltud Faerdref
Llantwit Major=Llanilltud Fawr
Llanvair Discoed=Llanfair Disgoed
Llanvetherine=Llanwytherin
Llanwern=Llan-wern
Llanwrtyd Wells=Llanwrtyd
Llanybri=Llan-y-bri
Llawhaden=Llanhuadain
Llay=Llai
Lletty Brongu=Lletybrongu
London=Llundain
Lonlas=Lôn-las
Loughor=Casllwchwr
Lower=Gwaelod
Lucerne=Luzern
Ludlow=Llwydlo
Luxembourg=Lwcsembwrg
Maescar=Maes-car
Maesglas=Maes-glas
Magor=Magwyr
Maindy=Y Maendy
Mamhilad=Mamheilad
Manchester=Manceinion
Mandle Terrace=Rhes Mandle
March of Wales=Y Mers
Margam Moors=Gweunydd Margam
Marine Terrace=Rhodfa'r Môr
Marseilles=Marseille
Marsh Road=Marsh Road
Members' Tea Room=Parlwr Te yr Aelodau
Menai Bridge=Porthaethwy
Menai Suspension Bridge=Pont Menai
Meredith Terrace=Ffordd Gefn
Merseyside=Glannau Mersi
Merthyr Tydfil Office=Swyddfa Merthyr Tudful
Merthyr Vale=Ynysowen
Mexico City=Dinas Mecsico
Mexico=Mecsico
Mezzanine=Mesanîn
Michaelston-le-pit=Llanfihangel-y-pwll
Michaelston-super-Ely=Llanfihangel-ar-Elái
Michaelstone-y-Fedw=Llanfihangel-y-fedw
Mid Glamorgan=Morgannwg Ganol
Mid Wales=Canolbarth Cymru
Middletown=Treberfedd
Midlands=Canolbarth Lloegr
Milford Haven=Aberdaugleddau
Mill Street=Dan Dre
Millennium Suite=Ystafell y Mileniwm
Minera=Mwynglawdd
Miskin=Meisgyn
Mitchel Troy=Llanfihangel Troddi
Mold=Yr Wyddgrug
Moldova=Moldofa
Monmouth and Brecon Canal=Camlas Mynwy ac Aberhonddu
Monmouth=Trefynwy
Montgomery=Trefaldwyn
Montgomeryshire=Sir Drefaldwyn
Montreal=Montréal
Morganstown=Treforgan
Morriston=Treforys
Moscow=Moskva (Moscow)
Mountain Ash=Aberpennar
Moylegrove=Trewyddel
Nantgarw Office=Swyddfa Nantgarw
Nantyci=Nant-y-ci
Naples=Napoli (Naples)
Narberth=Arberth
Nash=Trefonnen
National Assembly for Wales North Wales Visitor and Exhibition Centre=Canolfan Ymwelwyr ac Arddangosfeydd y Cynulliad Cenedlaethol yn y Gogledd
National Assembly for Wales Visitor and Exhibition Centre=Canolfan Ymwelwyr Cynulliad Cenedlaethol Cymru
Naval Temple=Y Deml Forol
Navigation Park=Parc Navigation
Neath Estuary=Aber Nedd
Neath Valley=Cwm Nedd
Neath=Castell-nedd
Netherlands=Yr Iseldiroedd
Nevern=Afon Nyfer
Nevern=Nanhyfer
New Broughton=Brychdyn Newydd
New Crown Building=Adeilad Newydd y Goron
New Dehli=Dehli Newydd
New Dolanog House=New Dolanog House
New Quay Watersports Centre=Canolfan Chwaraeon Dŵr Cei Newydd
New Quay=Ceinewydd
New Radnor=Maesyfed
New York=Efrog Newydd
New Zealand=Seland Newydd
Newborough Warren=Tywyn Niwbwrch
Newborough=Niwbwrch
Newbridge=Trecelyn
Newcastle Emlyn=Castellnewydd Emlyn
Newcastle=Castellnewydd
Newcastle=Y Castellnewydd
Newchurch=Llannewydd
Newport Deep=Dyfnfor Casnewydd
Newport Provisions Market=Marchnad Nwyddau Casnewydd
Newport=Trefdraeth
Newtown=Y Drenewydd
Normandy=Normandi
North Core=Craidd y Gogledd
North East Atlantic=Gogledd-ddwyrain Cefnfor Iwerydd
North Korea=Gogledd Korea
North Parade=Rhodfa'r Gogledd
North Pole=Pegwn y Gogledd
North Service Core=Craidd Gwasanaethau'r Gogledd
North Wales=Gogledd Cymru
North West Area=Ardal y Gogledd-orllewin
North West=Gogledd-orllewin Lloegr
North Wing=Adain y Gogledd
North Yorkshire=Gogledd Swydd Efrog
Northamptonshire=Swydd Northampton
Northern Gateway=Porth y Gogledd
Northgate Street=Stryd y Dollborth
Northop Hall Hotel=Gwesty Northop Hall
Northop=Llaneurgain
Norway=Norwy
Nottinghamshire=Swydd Nottingham
Oakleigh House=Tŷ Oakleigh
Ogmore Vale=Bro Ogwr
Oldcastle=Yr Hengastell
Onen=Onnen
Open Learning Centre=Canolfan Dysgu Agored
Oswestry=Croesoswallt
Oxfordshire=Swydd Rydychen
Oystermouth=Ystumllwynarth
Painscastle=Castell-paen
Pakistan=Pacistan
Palestine=Palesteina
Panteg=Pant-teg
Pantydwr=Pant-y-dŵr
Park Place=Parc-y-Plas
Park Place=Plas y Parc
Parson's Bridge=Pombren Ffeirad
Peak District National Park=Parc Cenedlaethol y Peak District
Pearl River Delta=Delta Afon Perl
Pembroke Dock=Doc Penfro
Pembroke=Penfro
Pembrokeshire Haven=Hafan Sir Benfro
Pen Tranch=Pen Transh
Pen-how=Pen-hw
Penally=Penalun
Pencoed Technology Park=Parc Technoleg Pencoed
Pencoedtre Park=Parc Pencoetre
Pendine=Pentywyn
Penllergaer Business Park=Parc Busnes Penlle'r-gaer
Penllergaer Forest=Coedwig Penlle'r-gaer
Penllergaer Office=Swyddfa Penlle'r-gaer
Penllergaer=Penlle'r-gaer
Penmaen=Pen-maen
Penmaenbach=Penmaen-bach
Penrice=Pen-rhys
Pentre Du=Pentre-du
Pentrebane=Pentre-baen
Penygarn=Pen-y-garn
Penygenhill Common=Comin Penygenhill
Peterstone-super-Ely=Llanbedr-y-fro
Philippines=Pilipinas (Ynysoedd Philippines)
Pier Street=Heol y Wig
Pilgwenlly=Pilgwenlli
Pilleth=Pyllalai
Pillgwenlly=Pillgwenlli
Plas Glyndwr=Plas Glyndŵr
Plynlimon=Pumlumon
Point of Ayr=Y Parlwr Du
Poland=Gwlad Pwyl
Pontcanna Fields=Meysydd Pontcanna
Pontrhydygroes=Pont-rhyd-y-groes
Pontyclun=Pont-y-clun
Pontypool=Pont-y-pŵl
Port Dinorwic=Y Felinheli
Port Penrhyn=Porth Penrhyn
Port of Mostyn=Porthladd Mostyn
Portugal=Portiwgal
Prague=Prag
Presteigne=Llanandras
Prince Llewelyn Terrace=Rhes y Tywysog Llewelyn
Princes Drive=Rhodfa'r Tywysog
Princes Park=Parc y Tywysog
Princess Gwenllian Centre=Canolfan Tywysoges Gwenllian
Principality House=Tŷ Principality
Puffin Island=Ynys Seiriol
Puncheston=Cas-mael
Pwllfawatkin=Pwllfa Watkin
Pyle=Y Pîl
QED Centre=Canolfan QED
Quay Parade=Pen Cei
Quay Street=Heol y Cei
Quebec=Québec
Queen Street=Heol y Frenhines
Queen's Lane=Heol y Frenhines
Queen's Road=Morfa Mawr
RAF Valley=RAF y Fali
Radyr=Radur
Ramsey Island=Ynys Dewi
Ramsey Sound=Swnt Dewi
Rassau=Rasa
Rathbone Terrace=Rhes Rathbone
Red Roses=Rhos-goch
Red Wharf Bay=Traeth Coch
Redstone Cross=Croesffordd Maencoch
Rennes=Roazhon (Rennes)
Republic of Ireland=Gweriniaeth Iwerddon
Republic of South Africa=Gweriniaeth De Affrica
Resolven=Resolfen
Rhandirmwyn=Rhandir-mwyn
Rhayader=Rhaeadr Gwy
Rhiwbina=Rhiwbeina
Rhoose=Y Rhws
Rhos-on-Sea=Llandrillo-yn-Rhos
Rhossili=Rhosili
Rhydycar=Rhyd-y-car
Rhyl Flats=Gwastadeddau'r Rhyl
Richmond Terrace=Waun Dew
Risca Palace=Palas Rhisga
Risca and Pontymister=Rhisga a Phont-y-meistr
Risca=Rhisga
River Ithon=Afon Ieithon
River Usk=Afon Wysg
River Walk=Rhodfa'r Afon
Riverside=Glan yr Afon
RoI=Gweriniaeth Iwerddon
Roath Basin=Basn y Rhath
Roath Lock Studios=Stiwdios Porth y Rhath
Roath=Y Rhath
Roch Castle=Castell y Garn
Rogerstone=Tŷ-du
Romania=Rwmania
Rome=Rhufain
Ross on Wye=Rhosan ar Wy
Rossett Business Village=Pentref Busnes Yr Orsedd
Rossett=Yr Orsedd
Rudry=Rhydri
Rumney=Tredelerch
Ruthin=Rhuthun
SA1 Swansea Waterfront=SA1 Glannau Abertawe
SA1 Waterfront=SA1 y Glannau
San Sebastian=Donostia/San Sebastián
Sarnybryncaled=Sarn y Bryn Caled
Scandinavia=Llychlyn
Scarweather Sands=Cefnenni Tywod Scarweather
Scilly Isles=Ynysoedd Scilly
Scotland=Yr Alban
Seawatch Centre=Gwylfan
Senghenydd=Senghennydd
Sennybridge=Pontsenni
Severn Road=Ffordd Hafren
Seville=Sevilla (Seville)
Shirenewton=Drenewydd Gelli-farch
Shrewsbury=Amwythig
Shropshire=Swydd Amwythig
Sicily=Sisili
Singapore=Singapôr
Sirhowy=Sirhywi
Skenfrith=Ynysgynwraidd
Skewen=Sgiwen
Skomer Island=Ynys Skomer
Slebech=Slebets
Slovakia=Slofacia
Slovenia=Slofenia
Somerset=Gwlad yr Haf
Sophia Gardens=Gerddi Sophia
South America=De America
South Core=Craidd y De
South Gloucestershire=De Swydd Gaerloyw
South Korea=De Korea
South Orkney Islands=Ynysoedd De Orkney
South Pole=Pegwn y De
South Road=Ffordd y De
South Service Core=Craidd Gwasanaethau'r De
South Stack=Ynys Lawd
South Wing=Adain y De
Southern Afan River Corridor=Coridor Deheuol Afon Afan
Southgate House=Tŷ Southgate
Spain=Sbaen
Splott=Y Sblot
Sri Lanka=Sri Lanca
St Andrews Place=Plas Sant Andreas
St Asaph Business Park=Parc Busnes Llanelwy
St Athan=Sain Tathan
St Brides Major=Saint-y-brid
St Brides Minor=Llansanffraid-ar-Ogwr
St Clears=Sanclêr
St David's House=Tŷ Dewi Sant
St David’s=Tyddewi
St Dials=Llanfihangel Llantarnam
St Dogmaels=Llandudoch
St Donats=Sain Dunwyd
St Fagans=Sain Ffagan
St Georges-super-Ely=Sain Siorys
St Hilary=St Hilari
St Issells=Llanysyllt
St Mary’s Church=Llan-fair
St Mellons=Llaneirwg
St Nicholas=Tremarchog
Stackpole Quay=Cei Ystangbwll
Staffordshire=Swydd Stafford
Staylittle=Penffordd-las
Steep Holm=Ynys Ronech
Strasbourg=Strasbwrg
Strumble Head=Pen-caer
Sudan=Y Swdan
Sugar Loaf=Dinas-y-bwlch
Sugar Loaf=Pen y Fâl
Sully=Sili
Swansea Bay=Bae Abertawe
Swansea Enterprise Park=Parc Anturiaeth Abertawe
Swansea Valley=Cwm Tawe
Swansea=Abertawe
Switzerland=Y Swistir
Tafarnaubach=Tafarnau-bach
Taff Bargoed Valley=Cwm Taf Bargoed
Taffs Well=Ffynnon Taf
Talbot Green=Tonysguboriau
Talley=Talyllychau
Tavernspite=Tafarn-sbeit
Tawe Business Village=Pentref Busnes Tawe
Temple of Peace and Health=Y Deml Heddwch ac Iechyd
Temple of Peace=Y Deml Heddwch
Templeton=Tredemel
Tenby=Dinbych-y-pysgod
Thailand=Gwlad Thai
The Balearic Islands=Ynysoedd Baleares
The Balkans=y Balcanau
The Basque Country=Gwlad y Basg
The Black Forest=Y Fforest Ddu
The Canary Isles=Yr Ynysoedd Dedwydd
The Coldra=Y Coldra
The Czech Republic=Y Weriniaeth Tsiec
The Fedw=Fedw
The Former Yugoslav Republic of Macedonia=Cyn-Weriniaeth Iwgoslafaidd Macedonia
The Friary=Heol y Brodyr Llwydion
The Great Hall=Y Neuadd Fawr
The Gurnos=Y Gurnos
The Highlands=Yr Ucheldiroedd/ Ucheldiroedd yr Alban
The Irish Republic=Gweriniaeth Iwerddon
The Kymin=Y Cymin
The Netherlands=Yr Iseldiroedd
The Old Welsh School=Yr Hen Ysgol Gymraeg
The Orchard=Y Berllan
The Orkney Isles=Ynysoedd Orkney
The Shetland Isles=Ynysoedd Shetland
The United Kingdom=Y Deyrnas Unedig
The Works: Ebbw Vale=Y Gweithfeydd: Glynebwy
The former Yugoslavia=Yr hen Iwgoslafia
Thessalonica=Thesalonica
Three Cocks=Aberllynfi
Tinkinswood=Llech y filiast
Tintern Abbey=Abaty Tyndyrn
Tintern=Tyndyrn
Towyn Trewan=Tywyn Trewan
Trafalgar House=Tŷ Trafalgar
Training Room=Ystafell Hyfforddi
Trecatti=Trecati
Trecwn=Trecŵn
Tredegar Business Park=Parc Busnes Tredegar
Tredegar Park=Parc Tredegar
Trefethin=Trefddyn
Treforest Industrial Estate=Ystad Ddiwydiannol Trefforest
Treforest=Trefforest
Treleck=Tryleg
Treorchy=Treorci
Turkey=Twrci
Tuscany=Twsgani
Ty Nant Court=Cwrt Tŷ Nant
Tyne and Wear=Tyne a Wear
Tywyn Point=Trwyn y Tywyn
Tŷ Glyndŵr=Tŷ Glyndŵr
Tŷ'r Llyn=Tŷ'r Llyn
Tŷ-Nant Court=Tŷ Nant Court
Tŷr Afon=Tŷ'r Afon
UK=DU
USA=UDA
USSR=Yr Undeb Sofietaidd
Ukraine=Ukrain
Undy Memorial Hall=Neuadd Goffa Gwndy
Unit=Uned
United Kingdom=Y Deyrnas Unedig
United States of America=Unol Daleithiau America
Upper Boat=Glan-bad
Upper=Blaenau
Usk=Brynbuga
Uskmouth=Aber-wysg
Vale of Usk=Dyffryn Wysg
Valle Crucis Abbey=Abaty Glyn y Groes
Valley=Y Fali
Valleys & South East=Y Cymoedd a'r De-orllewin
Valleys Information Technology and Communications Centre=Canolfan Technoleg Gwybodaeth a Chyfathrebu'r Cymoedd
Vaynor=Faenor
Venice=Fenis
Venture House=Tŷ Menter
Victoria Chambers=Siambrau Fictoria
Victoria Pier=Pier Victoria
Video Conferencing Room=Ystafell Fideogynadledda
Vienna=Fienna
Vietnam=Fiet-nam
Wainfelin=Waunfelin
Wales=Cymru
Walkway=y Rhodfa
Warsaw=Warszawa (Warsaw)
Warwickshire=Swydd Warwick
Waterfront Barry=Glannau'r Barri
Waterfront and Western Valleys=Y Glannau a’r Cymoedd Gorllewinol
Waterside Business Park=Parc Busnes Waterside
Welsh Assembly Government Choral Pavilion=Neuadd Gorawl Llywodraeth Cynulliad Cymru
Welsh St Donats=Llanddunwyd
Welshpool=Y Trallwng
Wentloog=Gwynllŵg
Wenvoe=Gwenfô
West Bank=Y Lan Orllewinol
West Core=Craidd y Gorllewin
West Midlands=Gorllewin Canolbarth  Lloegr
West Service Core=Craidd Gwasanaethau'r Gorllewin
West Shore=Pen Morfa
West Sussex=Gorllewin Sussex
West Wales=Gorllewin Cymru
West Wing=Adain y Gorllewin
West=Gorllewin
Western Bay Area=Ardal Bae'r Gorllewin
Western Cleddau=Cleddau Wen
Westgate Street=Heol y Porth
Whitchurch=Tre-groes
Whitchurch=Yr Eglwys Newydd
White Castle=Y Castell Gwyn
White Mill=Felin-wen
White Rose Information and Resource Centre=Canolfan Wybodaeth ac Adnoddau y Rhosyn Gwyn
Whitland=Hendy-gwyn ar Daf
Whitmore Bay=Bae Whitmore
Whitton=Llanddewi-yn-Hwytyn
Wick=Y Wig
Wiston=Cas-wis
Withybush=Llwynhelyg
Womanby Street=Stryd Womanby
Wood Street=Stryd Wood
Woodford Lane=Lôn Woodford
Worcester=Caerwrangon
Worcestershire=Swydd Gaerwrangon
Worms Head=Pen Pyrod
Wye Valley and the Vale of Usk=Dyffryn Gwy a Dyffryn Wysg
Wye Valley=Dyffryn Gwy
You are here=Rydych chi yma
Yugoslavia=Iwgoslafia
government offices=swyddfeydd llywodraeth
mainland Britain=tir mawr Prydain
river Dee=afon Dyfrdwy
